Space-Station-Escape
An Interactive Fiction by Ashton Smith
Release 1 / Serial number 250528 / Inform 7 build 6M62 (I6/v6.34 lib 6/12N) SD

Engineering Bay
You step into the bay. The room is cluttered with workbenches, oscilloscopes, and spacecraft schematics, all showing signs of frantic last-minute repairs.
There are two doorways: NORTH Command Deck SOUTH Escape Pod Bay 

You can see a radio, a MSDS Cabinet (closed) and a Tool Cabinet (closed) here.

>Hello
That's not a verb I recognise.

>North
There is no reason to go this way! Lets get to the escape pod immediatley!

>ok
That's not a verb I recognise.

>South
You might want to take the radio before going anywhere.

>take radio
Radio: Engineer, come in! The station's self-destruct sequence has been triggered-you have 90 minutes before total detonation. Get to the escape pod bay immediately!  

Type Reply to reply.

>open tool cabinet
You open the Tool Cabinet, revealing a hammer and a Repair Manual.

>take hammer
Taken.

>take repair manual
Taken.

Radio: Engineer, come in! Is everything okay over there?

 Type reply to reply.

>yes
That was a rhetorical question.

Radio: Engineer, come in! Is everything okay over there?

 Type reply to reply.

>reply
You respond to the radio: Acknowledged. Heading to the escape pod now.

>s
Escape Pod Bay
A cramped escape pod awaits - a last resort for emergencies. Panoramic windows reveal the cold expanse of space and a faint glimmer of the approaching rescue ship.
There is one doorway: NORTH Engineering Bay

You can see a Battery Panel (closed), a Control station (empty), a Takeoff Starter and a Cabin Storage (closed) here.

Radio: Engineer, come in! Why haven't you taken off in the escape pod yet?

>north
Engineering Bay
You step into the bay. The room is cluttered with workbenches, oscilloscopes, and spacecraft schematics, all showing signs of frantic last-minute repairs.
There are two doorways: NORTH Command Deck SOUTH Escape Pod Bay 

You can see a MSDS Cabinet (closed) and a Tool Cabinet (empty) here.

>south
Escape Pod Bay
A cramped escape pod awaits - a last resort for emergencies. Panoramic windows reveal the cold expanse of space and a faint glimmer of the approaching rescue ship.
There is one doorway: NORTH Engineering Bay

You can see a Battery Panel (closed), a Control station (empty), a Takeoff Starter and a Cabin Storage (closed) here.

>open cabin storage
You open the Cabin Storage, revealing an Escape Pod Control Manual.

>take escape pod control manual
Taken.

>i
You are carrying:
  an Escape Pod Control Manual
  a Repair Manual
  a hammer
  a radio

Radio: Engineer, come in! Is everything okay over there?

 Type reply to reply.

>x
What do you want to examine?

>x repair manual
The repair manual is an old book on space station repair, you quickly flip through it and take note of some key details:

- To install components like a steering wheel, try typing install steering wheel in control station.

- To open sealed panels, you may need a tool. Try typing open panel with power drill.

- To install batteries: Try typing put the ion battery in the battery panel.

It also mentions something about ensuring power is turned off before handling high-voltage components.

Radio: Engineer, come in! Is everything okay over there?

 Type reply to reply.

Radio: 45 minutes remain! If you can't figure out how to fix something try checking a Repair Manual!

>read escape pod control manual
A worn manual detailing installation and use of the escape pod's steering system, filled with diagrams and engineering shorthand. Scribbled on the back is: container 297b.

Radio: Engineer, come in! Is everything okay over there?

 Type reply to reply.

>reply no
I only understood you as far as wanting to reply.

>look
Escape Pod Bay
A cramped escape pod awaits - a last resort for emergencies. Panoramic windows reveal the cold expanse of space and a faint glimmer of the approaching rescue ship.
There is one doorway: NORTH Engineering Bay

You can see a Battery Panel (closed), a Control station (empty), a Takeoff Starter and a Cabin Storage (empty) here.

Radio: Engineer, come in! Is everything okay over there?

 Type reply to reply.

>north
Engineering Bay
You step into the bay. The room is cluttered with workbenches, oscilloscopes, and spacecraft schematics, all showing signs of frantic last-minute repairs.
There are two doorways: NORTH Command Deck SOUTH Escape Pod Bay 

You can see a MSDS Cabinet (closed) and a Tool Cabinet (empty) here.

Radio: Engineer, come in! Is everything okay over there?

 Type reply to reply.

>north
Command Deck
The nerve center of the station, once full of activity - now quiet, with blinking consoles and flickering readouts.
There are three doorways: EAST Storage Room SOUTH Engineering Bay WEST Battery Room

You can see a console and a chair (on which is a Captain's Glove) here.

Radio: Engineer, come in! Is everything okay over there?

 Type reply to reply.

>take glove
Taken.

Radio: Engineer, come in! Is everything okay over there?

 Type reply to reply.

>reply
You respond to the radio: The pod is broken! I will have to do some repairs first.

Radio: Engineer, The station's going to blow soon - you need to get that thing fixed or you are toast!

>look
Command Deck
The nerve center of the station, once full of activity - now quiet, with blinking consoles and flickering readouts.
There are three doorways: EAST Storage Room SOUTH Engineering Bay WEST Battery Room

You can see a console and a chair here.

>examin console
That's not a verb I recognise.

>look console
A central control console with various blinking lights. A drawer is built into the frame, but it appears to be locked by a biometric scanner.

>touch scanner
You feel nothing unexpected.

>hit scanner
Violence isn't the answer to this one.

>look
Command Deck
The nerve center of the station, once full of activity - now quiet, with blinking consoles and flickering readouts.
There are three doorways: EAST Storage Room SOUTH Engineering Bay WEST Battery Room

You can see a console and a chair here.

>inventory
You are carrying:
  a Captain's Glove
  an Escape Pod Control Manual
  a Repair Manual
  a hammer
  a radio

>glove on scanner
That's not a verb I recognise.

>use glove on scanner
You press the glove to the scanner. After a brief pause, the scanner beeps approvingly and the drawer pops open with a soft click.

>inspect
That's not a verb I recognise.

>look in drawer
In the drawer is a key.

>take key
Taken.

>look
Command Deck
The nerve center of the station, once full of activity - now quiet, with blinking consoles and flickering readouts.
There are three doorways: EAST Storage Room SOUTH Engineering Bay WEST Battery Room

You can see a console and a chair here.

>east
Storage Room
Stacks of containers fill the room, dimly lit and heavy with the acrid smell of burnt rubber and scorched electronics. 
 There is one doorway: WEST Command Deck

You can see a table (on which is a power drill), a container 300b (closed), a container 184c (closed), a container 225d (closed), a container 178e (closed), a container 118e (closed), a container 434e (closed), a container 152a (closed), a container 217c (closed), a container 297b (closed), a container 115a (closed), a container 479a (closed), a container 257a (closed), a container 257c (closed), a container 240d (closed), a container 297a (closed), a container 433e (closed), a container 268e (closed), a container 379e (closed), a container 391b (closed) and a container 293c (closed) here.

>take power drill
Taken.

>escape pod control manual look
That's not a verb I recognise.

>inspect escape pod control manual
That's not a verb I recognise.

>x escape pod control manual
A worn manual detailing installation and use of the escape pod's steering system, filled with diagrams and engineering shorthand. Scribbled on the back is: container 297b.

>open 297b
You open the container 297b, revealing a steering wheel, a spare landing gear spring and a plasma torch.

>take all
steering wheel: Taken.
spare landing gear spring: Taken.
plasma torch: Taken.

>look
Storage Room
Stacks of containers fill the room, dimly lit and heavy with the acrid smell of burnt rubber and scorched electronics. 
 There is one doorway: WEST Command Deck

You can see a table, a container 300b (closed), a container 184c (closed), a container 225d (closed), a container 178e (closed), a container 118e (closed), a container 434e (closed), a container 152a (closed), a container 217c (closed), a container 297b (empty), a container 115a (closed), a container 479a (closed), a container 257a (closed), a container 257c (closed), a container 240d (closed), a container 297a (closed), a container 433e (closed), a container 268e (closed), a container 379e (closed), a container 391b (closed) and a container 293c (closed) here.

>west
Command Deck
The nerve center of the station, once full of activity - now quiet, with blinking consoles and flickering readouts.
There are three doorways: EAST Storage Room SOUTH Engineering Bay WEST Battery Room

You can see a console and a chair here.

>south
Engineering Bay
You step into the bay. The room is cluttered with workbenches, oscilloscopes, and spacecraft schematics, all showing signs of frantic last-minute repairs.
There are two doorways: NORTH Command Deck SOUTH Escape Pod Bay 

You can see a MSDS Cabinet (closed) and a Tool Cabinet (empty) here.

>north
Command Deck
The nerve center of the station, once full of activity - now quiet, with blinking consoles and flickering readouts.
There are three doorways: EAST Storage Room SOUTH Engineering Bay WEST Battery Room

You can see a console and a chair here.

Radio: You've got 20 minutes remaining until the station explodes! You need to get moving!

>west
Battery Room
Dimly lit and filled with the hum of energy, the Battery Room houses the station's core power systems. Thick cables run along the walls, and a faint smell of ozone hangs in the air. 
There is one doorway: EAST Command Deck.

You can see a Power Switch and a Main Battery Panel (closed) here.

>look
Battery Room
Dimly lit and filled with the hum of energy, the Battery Room houses the station's core power systems. Thick cables run along the walls, and a faint smell of ozone hangs in the air. 
There is one doorway: EAST Command Deck.

You can see a Power Switch and a Main Battery Panel (closed) here.

>open main battery panel
The battery panel is secured with screws. You will need to unscrew them to open it.

>unscre
That's not a verb I recognise.

>unscrew
What do you want to unscrew?

>the battery panel
You must supply a second noun.

>unscrew the battery panel
You must supply a second noun.

>unscrew the main battery panel
You must supply a second noun.

>unscrew the power switch
You must supply a second noun.

>turn off power switch
You switch the Power Switch off.

>unscrew the main battery panel
You must supply a second noun.

>open the main battery panel with the power drill
You unlock the Main Battery Panel.

>inventory
You are carrying:
  a plasma torch
  a spare landing gear spring
  a steering wheel
  a power drill
  a key
  a Captain's Glove
  an Escape Pod Control Manual
  a Repair Manual
  a hammer
  a radio

>look
Battery Room
Dimly lit and filled with the hum of energy, the Battery Room houses the station's core power systems. Thick cables run along the walls, and a faint smell of ozone hangs in the air. 
There is one doorway: EAST Command Deck.

You can see a Power Switch and a Main Battery Panel (closed) here.

>east
The doors are inoperable while the power is off. Turn On the power switch if you are done here!

>west
The doors are inoperable while the power is off. Turn On the power switch if you are done here!

Radio: Good news! I was able to do a security override and extend the time by 20 minutes! But you need to hurry up! the self-destruct sequence cannot be stopped completley. I found some old repair manuals and to get the escape pod working you will need an ion battery, keys, and a steering wheel

>turn on power switch
You switch the Power Switch on.

>turn off power switch
You switch the Power Switch off.

>take battery
That's fixed in place.

>hit with hammer
You can't see any such thing.

>open the battery
You open the Main Battery Panel, revealing an Ion Battery.

* * *

>look
Battery Room
Dimly lit and filled with the hum of energy, the Battery Room houses the station's core power systems. Thick cables run along the walls, and a faint smell of ozone hangs in the air. 
There is one doorway: EAST Command Deck.

You can see a Power Switch and a Main Battery Panel (empty) here.

>east
The doors are inoperable while the power is off. Turn On the power switch if you are done here!

>turn on
What do you want to turn on?

>turn on switch
You switch the Power Switch on.

>look
Battery Room
Dimly lit and filled with the hum of energy, the Battery Room houses the station's core power systems. Thick cables run along the walls, and a faint smell of ozone hangs in the air. 
There is one doorway: EAST Command Deck.

You can see a Power Switch and a Main Battery Panel (empty) here.

>east
Command Deck
The nerve center of the station, once full of activity - now quiet, with blinking consoles and flickering readouts.
There are three doorways: EAST Storage Room SOUTH Engineering Bay WEST Battery Room

You can see a console and a chair here.

>south
Engineering Bay
You step into the bay. The room is cluttered with workbenches, oscilloscopes, and spacecraft schematics, all showing signs of frantic last-minute repairs.
There are two doorways: NORTH Command Deck SOUTH Escape Pod Bay 

You can see a MSDS Cabinet (closed) and a Tool Cabinet (empty) here.

>south
Escape Pod Bay
A cramped escape pod awaits - a last resort for emergencies. Panoramic windows reveal the cold expanse of space and a faint glimmer of the approaching rescue ship.
There is one doorway: NORTH Engineering Bay

You can see a Battery Panel (closed), a Control station (empty), a Takeoff Starter and a Cabin Storage (empty) here.

>look at repair manual
The repair manual is an old book on space station repair, you quickly flip through it and take note of some key details:

- To install components like a steering wheel, try typing install steering wheel in control station.

- To open sealed panels, you may need a tool. Try typing open panel with power drill.

- To install batteries: Try typing put the ion battery in the battery panel.

It also mentions something about ensuring power is turned off before handling high-voltage components.

>turn off power
It isn't something you can switch.

>open panel
You open the Battery Panel.

>put battery in panel
(the Ion Battery in the Battery Panel)
You put the Ion Battery into the Battery Panel.

>close panel
You close the Battery Panel.

>look
Escape Pod Bay
A cramped escape pod awaits - a last resort for emergencies. Panoramic windows reveal the cold expanse of space and a faint glimmer of the approaching rescue ship.
There is one doorway: NORTH Engineering Bay

You can see a Battery Panel (closed), a Control station (empty), a Takeoff Starter and a Cabin Storage (empty) here.

>inventory
You are carrying:
  a plasma torch
  a spare landing gear spring
  a steering wheel
  a power drill
  a key
  a Captain's Glove
  an Escape Pod Control Manual
  a Repair Manual
  a hammer
  a radio

>control station
That's not a verb I recognise.

>control station put wheel
That's not a verb I recognise.

>hit with hammer
You can't see any such thing.

>repair manual look
That's not a verb I recognise.

>look repair manual
The repair manual is an old book on space station repair, you quickly flip through it and take note of some key details:

- To install components like a steering wheel, try typing install steering wheel in control station.

- To open sealed panels, you may need a tool. Try typing open panel with power drill.

- To install batteries: Try typing put the ion battery in the battery panel.

It also mentions something about ensuring power is turned off before handling high-voltage components.

Radio: Good news! I was able to do a security override and extend the time by 20 minutes! But you need to hurry up! the self-destruct sequence cannot be stopped completley. I found some old repair manuals and to get the escape pod working you will need an ion battery, keys, and a steering wheel

>install steering wheel in control station
You snap the steering wheel into place. The control panel lights up with a hum.

The pod is totally fixed and we have the key! Maybe it is time to leave this old ship behind by starting up the escape pod!

hint: turn on takeoff starter to start the escape pod.

>turn on power
It isn't something you can switch.

>hit with hammer
You can't see any such thing.

>use key on starter
That doesn't seem to work.

>look
Escape Pod Bay
A cramped escape pod awaits - a last resort for emergencies. Panoramic windows reveal the cold expanse of space and a faint glimmer of the approaching rescue ship.
There is one doorway: NORTH Engineering Bay

You can see a Battery Panel (closed), a Control station (in which is a steering wheel), a Takeoff Starter and a Cabin Storage (empty) here.

>use key on takeoff starter
That doesn't seem to work.

The pod is totally fixed and we have the key! Maybe it is time to leave this old ship behind by starting up the escape pod!

hint: turn on takeoff starter to start the escape pod.

>insert key into takeoff starter
That can't contain things.

>turn on takeoff starter  with key
You can't see any such thing.

>turn on starter with key
You can't see any such thing.

>put key in starter
That can't contain things.

>hit with hammer
You can't see any such thing.

>turn on takeoff starter with key
You can't see any such thing.

>use key on takeoff starter
That doesn't seem to work.

>turn on takeoff starter with key
You can't see any such thing.

>turn on takeoff starter
You insert the keys and twist. The pod vibrates as it starts, systems come online, and you're launched into space. You made it!

    *** You escaped just in time! ***

Would you like to RESTART, RESTORE a saved game, QUIT or UNDO the last command?

Please give one of the answers above.

Would you like to RESTART, RESTORE a saved game, QUIT or UNDO the last command?

Please give one of the answers above.

Would you like to RESTART, RESTORE a saved game, QUIT or UNDO the last command?

* * *

Space-Station-Escape
An Interactive Fiction by Ashton Smith
Release 1 / Serial number 250528 / Inform 7 build 6M62 (I6/v6.34 lib 6/12N) SD

Engineering Bay
You step into the bay. The room is cluttered with workbenches, oscilloscopes, and spacecraft schematics, all showing signs of frantic last-minute repairs.
There are two doorways: NORTH Command Deck SOUTH Escape Pod Bay 

You can see a radio, a MSDS Cabinet (closed) and a Tool Cabinet (closed) here.

>i
You are carrying nothing.

Radio: yo u need to reply. Type reply to reply

>take radio
Radio: Engineer, come in! The station's self-destruct sequence has been triggered-you have 90 minutes before total detonation. Get to the escape pod bay immediately!  

Type Reply to reply.
Radio: yo u need to reply. Type reply to reply

>reply
You respond to the radio: Acknowledged. Heading to the escape pod now.

>look
Engineering Bay
The engineering bay - I need a description.

You can see a Repair Manual here.

>take repair manual
Taken.

>x repair manual
The repair manual is an old book on space station repair, you quickly flip through it and take note of some key details:

- To install components like a steering wheel, try typing install steering wheel in control station.

- To open sealed panels, you may need a tool. Try typing open panel with power drill.

- To install batteries: Try typing put the ion battery in the battery panel.

It also mentions something about ensuring power is turned off before handling high-voltage components.

>look
Engineering Bay
The engineering bay - I need a description.

>n
command deck
The Command Deck - I need a description.

You can see a key here.

>take key
Taken.

>s
Engineering Bay
The engineering bay - I need a description.

>s
Escape Pod Bay
The Escape pod bay - I need a description.

You can see a Battery Panel (closed), a Control station (empty) and a Takeoff Starter here.

Radio: yo u need to reply. Type reply to reply
Radio: Engineer, come in! Why haven't you taken off in the escape pod yet?

>take takeoff starter
That's fixed in place.

Radio: yo u need to reply. Type reply to reply

>x
What do you want to examine?

>x battery panel
You see nothing special about the Battery Panel.

Radio: yo u need to reply. Type reply to reply

>open battery panel
You open the Battery Panel.

Radio: yo u need to reply. Type reply to reply

>x battery panel
The Battery Panel is empty.

Radio: yo u need to reply. Type reply to reply

>x control station
The Control station is empty.

Radio: yo u need to reply. Type reply to reply

>n
Engineering Bay
The engineering bay - I need a description.

Radio: yo u need to reply. Type reply to reply

>n
command deck
The Command Deck - I need a description.

Radio: yo u need to reply. Type reply to reply

>e
storage room
The Storage Room - I need a description.

You can see a table (on which are a power drill and a steering wheel) here.

Radio: yo u need to reply. Type reply to reply

>take
(the table)
That's fixed in place.

Radio: yo u need to reply. Type reply to reply

>take power drill
Taken.

Radio: yo u need to reply. Type reply to reply

>take steering wheel
Taken.

Radio: yo u need to reply. Type reply to reply

>take all
There are none at all available!

>i
You are carrying:
  a steering wheel
  a power drill
  a key
  a Repair Manual
  a radio

Radio: yo u need to reply. Type reply to reply

>x repair manual
The repair manual is an old book on space station repair, you quickly flip through it and take note of some key details:

- To install components like a steering wheel, try typing install steering wheel in control station.

- To open sealed panels, you may need a tool. Try typing open panel with power drill.

- To install batteries: Try typing put the ion battery in the battery panel.

It also mentions something about ensuring power is turned off before handling high-voltage components.

Radio: yo u need to reply. Type reply to reply

>w
command deck
The Command Deck - I need a description.

Radio: yo u need to reply. Type reply to reply

>s
Engineering Bay
The engineering bay - I need a description.

Radio: yo u need to reply. Type reply to reply

>s
Escape Pod Bay
The Escape pod bay - I need a description.

You can see a Battery Panel (empty), a Control station (empty) and a Takeoff Starter here.

Radio: yo u need to reply. Type reply to reply

>install steering wheel in control station
You snap the steering wheel into place. The control panel lights up with a hum.

Radio: yo u need to reply. Type reply to reply

>e
You can't go that way.

Radio: yo u need to reply. Type reply to reply

>w
You can't go that way.

Radio: yo u need to reply. Type reply to reply

>s
You can't go that way.

Radio: yo u need to reply. Type reply to reply

>n
Engineering Bay
The engineering bay - I need a description.

Radio: yo u need to reply. Type reply to reply

>e
You can't go that way.

Radio: yo u need to reply. Type reply to reply

>s
Escape Pod Bay
The Escape pod bay - I need a description.

You can see a Battery Panel (empty), a Control station (in which is a steering wheel) and a Takeoff Starter here.

Radio: yo u need to reply. Type reply to reply

>n
Engineering Bay
The engineering bay - I need a description.

Radio: yo u need to reply. Type reply to reply

>w
You can't go that way.

Radio: yo u need to reply. Type reply to reply

I beg your pardon?

>n
command deck
The Command Deck - I need a description.

Radio: yo u need to reply. Type reply to reply

>e
storage room
The Storage Room - I need a description.

You can see a table here.

Radio: yo u need to reply. Type reply to reply

>w
command deck
The Command Deck - I need a description.

Radio: yo u need to reply. Type reply to reply

>w
Battery Room
The Battery Room - I need a description.

You can see a Power Switch and a Main Battery Panel (closed) here.

Radio: yo u need to reply. Type reply to reply

>swtich off power
That's not a verb I recognise.

>turn off power
(the power drill)
It isn't something you can switch.

Radio: yo u need to reply. Type reply to reply

>turn off switch
You switch the Power Switch off.

Radio: yo u need to reply. Type reply to reply

>open battery panel
It seems to be locked.

Radio: yo u need to reply. Type reply to reply

>drill battery panel
That's not a verb I recognise.

>use drill on battery panel
That's not a verb I recognise.

>i
You are carrying:
  a power drill
  a key
  a Repair Manual
  a radio

Radio: yo u need to reply. Type reply to reply

>put key in battery panel
The Main Battery Panel is closed.

Radio: yo u need to reply. Type reply to reply

>open battery panel
It seems to be locked.

Radio: yo u need to reply. Type reply to reply

>unlock battery panel
What do you want to unlock the Main Battery Panel with?

>key
That doesn't seem to fit the lock.

Radio: yo u need to reply. Type reply to reply

>w
The doors are inoperable while the power is off.

Radio: yo u need to reply. Type reply to reply

>turn power on
(the power drill on)
It isn't something you can switch.

Radio: yo u need to reply. Type reply to reply

>turn power switch on
You switch the Power Switch on.

Radio: yo u need to reply. Type reply to reply

>w
You can't go that way.

Radio: yo u need to reply. Type reply to reply

>e
command deck
The Command Deck - I need a description.

Radio: yo u need to reply. Type reply to reply

>w
Battery Room
The Battery Room - I need a description.

You can see a Power Switch and a Main Battery Panel (closed) here.

Radio: yo u need to reply. Type reply to reply

>w
You can't go that way.

Radio: yo u need to reply. Type reply to reply

>n
You can't go that way.

Radio: yo u need to reply. Type reply to reply

>s
You can't go that way.

Radio: yo u need to reply. Type reply to reply

>e
command deck
The Command Deck - I need a description.

Radio: yo u need to reply. Type reply to reply

>n
You can't go that way.

Radio: yo u need to reply. Type reply to reply

>w
Battery Room
The Battery Room - I need a description.

You can see a Power Switch and a Main Battery Panel (closed) here.

Radio: yo u need to reply. Type reply to reply

>x main battery panel
You see nothing special about the Main Battery Panel.

Radio: yo u need to reply. Type reply to reply

>x repair manual
The repair manual is an old book on space station repair, you quickly flip through it and take note of some key details:

- To install components like a steering wheel, try typing install steering wheel in control station.

- To open sealed panels, you may need a tool. Try typing open panel with power drill.

- To install batteries: Try typing put the ion battery in the battery panel.

It also mentions something about ensuring power is turned off before handling high-voltage components.

Radio: yo u need to reply. Type reply to reply

>turn off switch
You switch the Power Switch off.

Radio: yo u need to reply. Type reply to reply

>open panel with power drill
You unlock the Main Battery Panel.

Radio: yo u need to reply. Type reply to reply

>open main battery panel
You open the Main Battery Panel, revealing an Ion Battery.

Radio: yo u need to reply. Type reply to reply

>take ion battery
Radio: yo u need to reply. Type reply to reply

>e
The doors are inoperable while the power is off.

Radio: yo u need to reply. Type reply to reply

>turn swtich on
You can't see any such thing.

>turn switch on
You switch the Power Switch on.

Radio: yo u need to reply. Type reply to reply

>e
command deck
The Command Deck - I need a description.

Radio: yo u need to reply. Type reply to reply

>e
storage room
The Storage Room - I need a description.

You can see a table here.

Radio: yo u need to reply. Type reply to reply

* * *

>s
Engineering Bay
The engineering bay - I need a description.

Radio: yo u need to reply. Type reply to reply

>s
Escape Pod Bay
The Escape pod bay - I need a description.

You can see a Battery Panel (empty), a Control station (in which is a steering wheel) and a Takeoff Starter here.

Radio: yo u need to reply. Type reply to reply

>put battery in battery panel
(the Ion Battery in the Battery Panel)
You put the Ion Battery into the Battery Panel.

Radio: yo u need to reply. Type reply to reply

>x repair manual
The repair manual is an old book on space station repair, you quickly flip through it and take note of some key details:

- To install components like a steering wheel, try typing install steering wheel in control station.

- To open sealed panels, you may need a tool. Try typing open panel with power drill.

- To install batteries: Try typing put the ion battery in the battery panel.

It also mentions something about ensuring power is turned off before handling high-voltage components.

Radio: yo u need to reply. Type reply to reply

>start starter
That's not a verb I recognise.

>turn on starter
You insert the keys and twist. The pod vibrates as it starts, systems come online, and you're launched into space. You made it!
You try to start the pod, but the system errors out. Maybe something important is missing.

    *** You escaped just in time! ***

Would you like to RESTART, RESTORE a saved game, QUIT or UNDO the last command?

* * *

Space-Station-Escape
An Interactive Fiction by Ashton Smith
Release 1 / Serial number 250528 / Inform 7 build 6M62 (I6/v6.34 lib 6/12N) SD

Engineering Bay
You step into the bay. The room is cluttered with workbenches, oscilloscopes, and spacecraft schematics, all showing signs of frantic last-minute repairs.
There are two doorways: NORTH Command Deck SOUTH Escape Pod Bay 

You can see a radio, a MSDS Cabinet (closed) and a Tool Cabinet (closed) here.

>look
Engineering Bay
You step into the bay, the room is filled with work benches, osciloscopes, and space ship schematics.
There are two doorways: NORTH Command Deck SOUTH Escape Pod Bay 

You can see a radio, a MSDS Cabinet (closed) and a Tool Cabinet (closed) here.

>take all
radio: Radio: Engineer, come in! The station's self-destruct sequence has been triggered-you have 90 minutes before total detonation. Get to the escape pod bay immediately!  

Type Reply to reply.

>x excape pod control manual
You can't see any such thing.

>x escape pod
You can't see any such thing.

>n
There is no reason to go this way! Lets get to the escape pod immediatley!

>s
Escape Pod Bay
A small spherical spaceship used for emergencies. There are windows all around you and you can see into the emptiness of space - You also can spot the rescue ship in the distance.
There is one doorway: NORTH Engineering Bay

You can see a Battery Panel (closed), a Control station (empty), a Takeoff Starter and a Cabin Storage (closed) here.

Radio: Engineer, come in! Why haven't you taken off in the escape pod yet?

>x cabin storage
You see nothing special about the Cabin Storage.

>open cabin storage
You open the Cabin Storage, revealing an Escape Pod Control Manual.

Radio: Engineer, come in! Is everything okay over there?

 Type reply to reply.

>take escape pod control
Taken.

Radio: Engineer, come in! Is everything okay over there?

 Type reply to reply.

>reply
You respond to the radio: The pod is broken! I will have to do some repairs first.

Radio: Engineer, The station's going to blow soon - you need to get that thing fixed or you are toast!

>reply
You respond to the radio: How much time do I have??

Radio: You've got 79.75 minutes until the station self destructs!

>x
What do you want to examine?

>look
Escape Pod Bay
A small spherical spaceship used for emergencies. There are windows all around you and you can see into the emptiness of space - You also can spot the rescue ship in the distance.
There is one doorway: NORTH Engineering Bay

You can see a Battery Panel (closed), a Control station (empty), a Takeoff Starter and a Cabin Storage (empty) here.

>n
Engineering Bay
You step into the bay, the room is filled with work benches, osciloscopes, and space ship schematics.
There are two doorways: NORTH Command Deck SOUTH Escape Pod Bay 

You can see a MSDS Cabinet (closed) and a Tool Cabinet (closed) here.

>open msds cabinet
You open the MSDS Cabinet, revealing a 'MSDS'.

>open tool cabinet
You open the Tool Cabinet, revealing a hammer and a Repair Manual.

>take repair manual
Taken.

* * *

>x repair manual
The repair manual is an old book on space station repair, you quickly flip through it and take note of some key details:

- To install components like a steering wheel, try typing install steering wheel in control station.

- To open sealed panels, you may need a tool. Try typing open panel with power drill.

- To install batteries: Try typing put the ion battery in the battery panel.

It also mentions something about ensuring power is turned off before handling high-voltage components.

>n
Command Deck
The room where all the decisions for the space station are made. 
There are three doorways: EAST Storage Room SOUTH Engineering Bay WEST Battery Room

You can see a key here.

>x key
These look like keys to a space ship, maybe these could be used to start one up?

>take key
Taken.

>look
Command Deck
The room where all the decisions for the space station are made. 
There are three doorways: EAST Storage Room SOUTH Engineering Bay WEST Battery Room

>west
Battery Room
The Battery Room - I need a description.
 There is one doorway: EAST Command Deck

You can see a Power Switch and a Main Battery Panel (closed) here.

>turn off power
You switch the Power Switch off.

>unscrew main battery panel
It is fixed in place.

>unscrew main battery panel with power drill
I only understood you as far as wanting to unscrew the Main Battery Panel.

>w
The doors are inoperable while the power is off.

>s
The doors are inoperable while the power is off.

>e
The doors are inoperable while the power is off.

>look
Battery Room
The Battery Room - I need a description.
 There is one doorway: EAST Command Deck

You can see a Power Switch and a Main Battery Panel (closed) here.

>e
The doors are inoperable while the power is off.

>turn power on
You switch the Power Switch on.

>e
Command Deck
The room where all the decisions for the space station are made. 
There are three doorways: EAST Storage Room SOUTH Engineering Bay WEST Battery Room

>e
storage room
This room is filled with containers and smells like burnt tires in here. 
 There is one doorway: WEST Command Deck

You can see a table (on which is a power drill), a container 300b (closed), a container 184c (closed), a container 225d (closed), a container 178e (closed), a container 118e (closed), a container 434e (closed), a container 152a (closed), a container 217c (closed), a container 297b (closed), a container 115a (closed), a container 479a (closed), a container 257a (closed), a container 257c (closed), a container 240d (closed), a container 297a (closed), a container 433e (closed), a container 268e (closed), a container 379e (closed), a container 391b (closed) and a container 293c (closed) here.

Radio: You've got 60 minutes remaining until the station explodes! You need to get moving!

>i
You are carrying:
  a key
  a Repair Manual
  an Escape Pod Control Manual
  a radio

>x escape pod contorl manual
I only understood you as far as wanting to examine the Escape Pod Control Manual.

>x Escape Pod Control manual
A manual for the steering wheel of the standard issue escape pod, with some diagrams and instructions. Scribbled on the back is: container 297b

>open 297b
You open the container 297b, revealing a steering wheel, a spare landing gear spring and a plasma torch.

>take steering wheel
Taken.

>x repair manual
The repair manual is an old book on space station repair, you quickly flip through it and take note of some key details:

- To install components like a steering wheel, try typing install steering wheel in control station.

- To open sealed panels, you may need a tool. Try typing open panel with power drill.

- To install batteries: Try typing put the ion battery in the battery panel.

It also mentions something about ensuring power is turned off before handling high-voltage components.

>take power drill
Taken.

>w
Command Deck
The room where all the decisions for the space station are made. 
There are three doorways: EAST Storage Room SOUTH Engineering Bay WEST Battery Room

>w
Battery Room
The Battery Room - I need a description.
 There is one doorway: EAST Command Deck

You can see a Power Switch and a Main Battery Panel (closed) here.

>open main battery panel with powerdrill
You can't see any such thing.

>open panel with power drill
You unlock the Main Battery Panel.

>unscrew main battery panel
It is fixed in place.

>unscrew main battery panel
It is fixed in place.

>open main battery panel
You open the Main Battery Panel, revealing an Ion Battery.

>take ion batter
I only understood you as far as wanting to take the Ion Battery.

>take ion battery
You just got shocked!! Maybe we should try to turn the power off.

Radio: 45 minutes remain! If you can't figure out how to fix something try checking a Repair Manual!

>turn off power
(the power drill)
It isn't something you can switch.

>turn off power switch
You switch the Power Switch off.

* * *

>w
The doors are inoperable while the power is off.

>turn on power switch
You switch the Power Switch on.

>w
You can't go that way.

>look
Battery Room
The Battery Room - I need a description.
 There is one doorway: EAST Command Deck

You can see a Power Switch and a Main Battery Panel (empty) here.

>e
Command Deck
The room where all the decisions for the space station are made. 
There are three doorways: EAST Storage Room SOUTH Engineering Bay WEST Battery Room

>i
You are carrying:
  an Ion Battery
  a power drill
  a steering wheel
  a key
  a Repair Manual
  an Escape Pod Control Manual
  a radio

>s
Engineering Bay
You step into the bay, the room is filled with work benches, osciloscopes, and space ship schematics.
There are two doorways: NORTH Command Deck SOUTH Escape Pod Bay 

You can see a MSDS Cabinet (in which is a 'MSDS') and a Tool Cabinet (in which is a hammer) here.

>s
Escape Pod Bay
A small spherical spaceship used for emergencies. There are windows all around you and you can see into the emptiness of space - You also can spot the rescue ship in the distance.
There is one doorway: NORTH Engineering Bay

You can see a Battery Panel (closed), a Control station (empty), a Takeoff Starter and a Cabin Storage (empty) here.

>reply
You respond to the radio: How much time do I have??

Radio: You've got 34.5 minutes until the station self destructs!

>reply
You respond to the radio: How much time do I have??

Radio: You've got 33.5 minutes until the station self destructs!

>reply
You respond to the radio: How much time do I have??

Radio: You've got 32.5 minutes until the station self destructs!

>reply
You respond to the radio: How much time do I have??

Radio: You've got 31.5 minutes until the station self destructs!

>s
You can't go that way.

>n
Engineering Bay
You step into the bay, the room is filled with work benches, osciloscopes, and space ship schematics.
There are two doorways: NORTH Command Deck SOUTH Escape Pod Bay 

You can see a MSDS Cabinet (in which is a 'MSDS') and a Tool Cabinet (in which is a hammer) here.

>reply
You respond to the radio: How much time do I have??

Radio: You've got 28.5 minutes until the station self destructs!

>repl
That's not a verb I recognise.

>north
Command Deck
The room where all the decisions for the space station are made. 
There are three doorways: EAST Storage Room SOUTH Engineering Bay WEST Battery Room

>reply
You respond to the radio: How much time do I have??

Radio: You've got 25.5 minutes until the station self destructs!

>i
You are carrying:
  an Ion Battery
  a power drill
  a steering wheel
  a key
  a Repair Manual
  an Escape Pod Control Manual
  a radio

>reply
You respond to the radio: How much time do I have??

Radio: You've got 24.5 minutes until the station self destructs!

>reply
You respond to the radio: How much time do I have??

Radio: You've got 23.5 minutes until the station self destructs!

I beg your pardon?

I beg your pardon?

>reply
You respond to the radio: How much time do I have??

Radio: You've got 22.5 minutes until the station self destructs!

>reply
You respond to the radio: How much time do I have??

Radio: You've got 21.5 minutes until the station self destructs!

>reply
You respond to the radio: How much time do I have??

Radio: You've got 20.5 minutes until the station self destructs!

>reply
You respond to the radio: How much time do I have??

Radio: You've got 19.5 minutes until the station self destructs!

>reply
You respond to the radio: How much time do I have??

Radio: You've got 18.5 minutes until the station self destructs!

>reply
You respond to the radio: How much time do I have??

Radio: You've got 17.5 minutes until the station self destructs!

>reply
You respond to the radio: How much time do I have??

Radio: You've got 16.5 minutes until the station self destructs!

>reply
You respond to the radio: How much time do I have??

Radio: You've got 15.5 minutes until the station self destructs!

>reply
You respond to the radio: How much time do I have??

Radio: You've got 14.5 minutes until the station self destructs!

>reply
You respond to the radio: How much time do I have??

Radio: You've got 13.5 minutes until the station self destructs!

>reply
You respond to the radio: How much time do I have??

Radio: You've got 12.5 minutes until the station self destructs!

>i
You are carrying:
  an Ion Battery
  a power drill
  a steering wheel
  a key
  a Repair Manual
  an Escape Pod Control Manual
  a radio

>north
You can't go that way.

>south
Engineering Bay
You step into the bay, the room is filled with work benches, osciloscopes, and space ship schematics.
There are two doorways: NORTH Command Deck SOUTH Escape Pod Bay 

You can see a MSDS Cabinet (in which is a 'MSDS') and a Tool Cabinet (in which is a hammer) here.

>reply
You respond to the radio: How much time do I have??

Radio: You've got 9.5 minutes until the station self destructs!

>reply
You respond to the radio: How much time do I have??

Radio: You've got 8.5 minutes until the station self destructs!

>n
Command Deck
The room where all the decisions for the space station are made. 
There are three doorways: EAST Storage Room SOUTH Engineering Bay WEST Battery Room

>n
You can't go that way.

>e
storage room
This room is filled with containers and smells like burnt tires in here. 
 There is one doorway: WEST Command Deck

You can see a table, a container 300b (closed), a container 184c (closed), a container 225d (closed), a container 178e (closed), a container 118e (closed), a container 434e (closed), a container 152a (closed), a container 217c (closed), a container 297b (in which are a spare landing gear spring and a plasma torch), a container 115a (closed), a container 479a (closed), a container 257a (closed), a container 257c (closed), a container 240d (closed), a container 297a (closed), a container 433e (closed), a container 268e (closed), a container 379e (closed), a container 391b (closed) and a container 293c (closed) here.

>w
Command Deck
The room where all the decisions for the space station are made. 
There are three doorways: EAST Storage Room SOUTH Engineering Bay WEST Battery Room

Radio: Good news! I was able to do a security override and extend the time by 20 minutes! But you need to hurry up! the self-destruct sequence cannot be stopped completley. I found some old repair manuals and to get the escape pod working you will need an ion battery, keys, and a steering wheel

>reply
You respond to the radio: How much time do I have??

Radio: You've got 23.5 minutes until the station self destructs!

* * *

Space-Station-Escape
An Interactive Fiction by Ashton Smith
Release 1 / Serial number 250528 / Inform 7 build 6M62 (I6/v6.34 lib 6/12N) SD

Engineering Bay
You step into the bay. The room is cluttered with workbenches, oscilloscopes, and spacecraft schematics, all showing signs of frantic last-minute repairs.
There are two doorways: NORTH Command Deck SOUTH Escape Pod Bay 

You can see a radio, a MSDS Cabinet (closed) and a Tool Cabinet (closed) here.

>n
You might want to take the radio before going anywhere.

Radio: yo u need to reply. Type reply to reply

>s
There is no reason to go this way! Lets get to the escape pod immediatley!

Radio: yo u need to reply. Type reply to reply

>n
You might want to take the radio before going anywhere.

>take radio
Taken.

>x
(the radio)
You see nothing special about the radio.

>n
command deck

>s
Engineering Bay

>s
Escape Pod Bay
You can see a Battery Panel (closed) and a Control station (empty) here.

>x
(the radio)
You see nothing special about the radio.

* * *

>s
There is no reason to go this way! Lets get to the escape pod immediatley!

Radio: yo u need to reply. Type reply to reply

>take radio
Radio: Engineer, come in! The station's self-destruct sequence has been triggered-you have 90 minutes before total detonation. Get to the escape pod bay immediately!  

Type Reply to reply.
Radio: yo u need to reply. Type reply to reply

>n
command deck
The Command Deck - I need a description.

You can see a key here.

Radio: yo u need to reply. Type reply to reply

* * *

Space-Station-Escape
An Interactive Fiction by Ashton Smith
Release 1 / Serial number 250528 / Inform 7 build 6M62 (I6/v6.34 lib 6/12N) SD

Engineering Bay
You step into the bay. The room is cluttered with workbenches, oscilloscopes, and spacecraft schematics, all showing signs of frantic last-minute repairs.
There are two doorways: NORTH Command Deck SOUTH Escape Pod Bay 

You can see a radio, a MSDS Cabinet (closed) and a Tool Cabinet (closed) here.

>north
There is no reason to go this way! Lets get to the escape pod immediatley!

>escape
That's not a verb I recognise.

>south
You might want to take the radio before going anywhere.

>take radio
Radio: Engineer, come in! The station's self-destruct sequence has been triggered-you have 90 minutes before total detonation. Get to the escape pod bay immediately!  

Type Reply to reply.

>reply
You respond to the radio: Acknowledged. Heading to the escape pod now.

>head to the escape pod
That's not a verb I recognise.

>northeast
You can't go that way.

>south
Escape Pod Bay
The Escape pod bay - There is one doorway  NORTH  Engineering Bay.

You can see a Battery Panel (closed), a Control station (empty) and a Takeoff Starter here.

Radio: Engineer, come in! Why haven't you taken off in the escape pod yet?

>taken off
That's not a verb I recognise.

>come in
That's not a verb I recognise.

>go
You'll have to say which compass direction to go in.

>south
You can't go that way.

>fix
That's not a verb I recognise.

>closed
That's not a verb I recognise.

>reply
You respond to the radio: The pod is broken! I will have to do some repairs first.

Radio: Engineer, The station's going to blow soon - you need to get that thing fixed or you are toast!

>repair
That's not a verb I recognise.

>south
You can't go that way.

>north
Engineering Bay
The engineering bay - There are doorways  NORTH  Engineering Bay.

You can see a Repair Manual and an Escape Pod Control Manual here.

>repair
That's not a verb I recognise.

>ttake
That's not a verb I recognise.

>take
What do you want to take?

>take repair manual and a steering wheel
You can't see any such thing.

>i
You are carrying:
  a radio

>x steer
You can't see any such thing.

>x steering
You can't see any such thing.

>x repair
The repair manual is an old book on space station repair, you quickly flip through it and take note of some key details:

- To install components like a steering wheel, try typing install steering wheel in control station.

- To open sealed panels, you may need a tool. Try typing open panel with power drill.

- To install batteries: Try typing put the ion battery in the battery panel.

It also mentions something about ensuring power is turned off before handling high-voltage components.

>look
Engineering Bay
The engineering bay - There are doorways  NORTH  Engineering Bay.

You can see a Repair Manual and an Escape Pod Control Manual here.

>n
command deck
The Command Deck - I need a description.

You can see a key here.

>take a key
Taken.

>n
You can't go that way.

>s
Engineering Bay
The engineering bay - There are doorways  NORTH  Engineering Bay.

You can see a Repair Manual and an Escape Pod Control Manual here.

>n
command deck
The Command Deck - I need a description.

>e
storage room
The Storage Room - I need a description.

You can see a table (on which is a power drill), a container 300b (closed), a container 184c (closed), a container 225d (closed), a container 178e (closed), a container 118e (closed), a container 434e (closed), a container 152a (closed), a container 217c (closed), a container 297b (closed), a container 115a (closed), a container 479a (closed), a container 257a (closed), a container 257c (closed), a container 240d (closed), a container 297a (closed), a container 433e (closed), a container 268e (closed), a container 379e (closed), a container 391b (closed) and a container 293c (closed) here.

>take everything
power drill: Taken.

>o
Sorry, that can't be corrected.

>open
What do you want to open?

>container
Which do you mean, the container 300b, the container 184c, the container 225d, the container 178e, the container 118e, the container 434e, the container 152a, the container 217c, the container 297b, the container 115a, the container 479a, the container 257a, the container 257c, the container 240d, the container 297a, the container 433e, the container 268e, the container 379e, the container 391b or the container 293c?

>take
What do you want to take?

>everything
There are none at all available!

>take all
There are none at all available!

>i
You are carrying:
  a power drill
  a key
  a radio

>open 300b
You open the container 300b, revealing an oxygen regulator, a magnetic boots and a plasma rifle.

>take all
oxygen regulator: Taken.
magnetic boots: Taken.
plasma rifle: Taken.

>check steering wheel manual
You can't see any such thing.

>open 297b
You open the container 297b, revealing a steering wheel, a spare landing gear spring and a plasma torch.

* * *

>take all
steering wheel: Taken.
spare landing gear spring: Taken.
plasma torch: Taken.

>i
You are carrying:
  a plasma torch
  a spare landing gear spring
  a steering wheel
  a plasma rifle
  a magnetic boots
  an oxygen regulator
  a power drill
  a key
  a radio

>w
command deck
The Command Deck - I need a description.

>w
Battery Room
The Battery Room - I need a description.

You can see a Power Switch and a Main Battery Panel (closed) here.

>open
What do you want to open?

>main battery panel
It seems to be locked.

>open power switch
It isn't something you can open.

>use key
That's not a verb I recognise.

>open a main battery panel
It seems to be locked.

>read repair manual
You can't see any such thing.

>open panel with power drill
You unlock the Main Battery Panel.

>open a main battery panel
You open the Main Battery Panel, revealing an Ion Battery.

>take
What do you want to take?

>all
Ion Battery: You just got shocked!! Maybe we should try to turn the power off.

>power off
That's not a verb I recognise.

>look
Battery Room
The Battery Room - I need a description.

You can see a Power Switch and a Main Battery Panel (in which is an Ion Battery) here.

>power switch off
That's not a verb I recognise.

>tun off power switch
That's not a verb I recognise.

>turn off power switch
You switch the Power Switch off.

>take all
Ion Battery:

>e
The doors are inoperable while the power is off.

>e
The doors are inoperable while the power is off.

>turn power on
(the power drill on)
It isn't something you can switch.

>turn on the power switch
You switch the Power Switch on.

>e
command deck
The Command Deck - I need a description.

>n
You can't go that way.

* * *

>s
Engineering Bay
The engineering bay - There are doorways  NORTH  Engineering Bay.

You can see a Repair Manual and an Escape Pod Control Manual here.

>s
Escape Pod Bay
The Escape pod bay - There is one doorway  NORTH  Engineering Bay.

You can see a Battery Panel (closed), a Control station (empty) and a Takeoff Starter here.

>open battery panel
You open the Battery Panel.

>look
Escape Pod Bay
The Escape pod bay - There is one doorway  NORTH  Engineering Bay.

You can see a Battery Panel (empty), a Control station (empty) and a Takeoff Starter here.

>put the battery
What do you want to put the Ion Battery in?

>in
I didn't understand that sentence.

>put the battery in the battery panel
(the Ion Battery in the Battery Panel)
You put the Ion Battery into the Battery Panel.

>turn it on
It isn't something you can switch.

>look
Escape Pod Bay
The Escape pod bay - There is one doorway  NORTH  Engineering Bay.

You can see a Battery Panel (in which is an Ion Battery), a Control station (empty) and a Takeoff Starter here.

>x repair
You can't see any such thing.

>install steering wheel in control station
You snap the steering wheel into place. The control panel lights up with a hum.

>yes
That was a rhetorical question.

>install steering wheel in control station
You snap the steering wheel into place. The control panel lights up with a hum.

>install the steering wheel in control station
You snap the steering wheel into place. The control panel lights up with a hum.

>install the steering wheelin control station
I didn't understand that sentence.

I beg your pardon?

>loook
That's not a verb I recognise.

>look
Escape Pod Bay
The Escape pod bay - There is one doorway  NORTH  Engineering Bay.

You can see a Battery Panel (in which is an Ion Battery), a Control station (in which is a steering wheel) and a Takeoff Starter here.

>star
That's not a verb I recognise.

>start
That's not a verb I recognise.

>use key
That's not a verb I recognise.

>use key on takeoff starter
That's not a verb I recognise.

>i
You are carrying:
  a plasma torch
  a spare landing gear spring
  a plasma rifle
  a magnetic boots
  an oxygen regulator
  a power drill
  a key
  a radio

>turn on takeoff starter
You insert the keys and twist. The pod vibrates as it starts, systems come online, and you're launched into space. You made it!
You try to start the pod, but the system errors out. Maybe something important is missing.

    *** You escaped just in time! ***

Would you like to RESTART, RESTORE a saved game, QUIT or UNDO the last command?

* * *

Space-Station-Escape
An Interactive Fiction by Ashton Smith
Release 1 / Serial number 250528 / Inform 7 build 6M62 (I6/v6.34 lib 6/12N) SD

Engineering Bay
You step into the bay. The room is cluttered with workbenches, oscilloscopes, and spacecraft schematics, all showing signs of frantic last-minute repairs.
There are two doorways: NORTH Command Deck SOUTH Escape Pod Bay 

You can see a radio, a MSDS Cabinet (closed) and a Tool Cabinet (closed) here.

>r
That's not a verb I recognise.

>reply
I didn't understand that sentence.

>take radio
Radio: Engineer, come in! The station's self-destruct sequence has been triggered-you have 90 minutes before total detonation. Get to the escape pod bay immediately!

>replay
That's not a verb I recognise.

>reply
I didn't understand that sentence.

>reply to radio
You respond to the radio. Acknowledged. Heading to the escape pod now.f

* * *

Space-Station-Escape
An Interactive Fiction by Ashton Smith
Release 1 / Serial number 250528 / Inform 7 build 6M62 (I6/v6.34 lib 6/12N) SD

Engineering Bay
You step into the bay. The room is cluttered with workbenches, oscilloscopes, and spacecraft schematics, all showing signs of frantic last-minute repairs.
There are two doorways: NORTH Command Deck SOUTH Escape Pod Bay 

You can see a radio, a MSDS Cabinet (closed) and a Tool Cabinet (closed) here.

>reply
You need to have the radio to respond.

>take radio
Radio: Engineer, come in! The station's self-destruct sequence has been triggered-you have 90 minutes before total detonation. Get to the escape pod bay immediately!  Type Reply to reply.

>reply
You respond to the radio: How much time do I have??Radio: time remaining is x minutesYou respond to the radio: Acknowledged. Heading to the escape pod now.

* * *

Space-Station-Escape
An Interactive Fiction by Ashton Smith
Release 1 / Serial number 250528 / Inform 7 build 6M62 (I6/v6.34 lib 6/12N) SD

Engineering Bay
You step into the bay. The room is cluttered with workbenches, oscilloscopes, and spacecraft schematics, all showing signs of frantic last-minute repairs.
There are two doorways: NORTH Command Deck SOUTH Escape Pod Bay 

You can see a radio, a MSDS Cabinet (closed) and a Tool Cabinet (closed) here.

>s
You might want to take the radio before going anywhere.

>n
There is no reason to go this way! Lets get to the escape pod immediatley!

>e
You might want to take the radio before going anywhere.

>take radio
Radio: Engineer, come in! The station's self-destruct sequence has been triggered-you have 90 minutes before total detonation. Get to the escape pod bay immediately!  

Type Reply to reply.

>s
Escape Pod Bay
The Escape pod bay - I need a description.

You can see a Battery Panel (closed), a Control station (empty) and a Takeoff Starter here.

Radio: Engineer, come in! Why haven't you taken off in the escape pod yet?

>reply
You respond to the radio: The pod is broken! I will have to do some repairs first.

Radio: Engineer, The station's going to blow soon - you need to get that thing fixed or you are toast!

>n
Engineering Bay
The engineering bay - I need a description.

You can see a Repair Manual and a steering wheel manual here.

>n
command deck
The Command Deck - I need a description.

You can see a key here.

* * *

>n
There is no reason to go this way! Lets get to the escape pod immediatley!

>take radio
Radio: Engineer, come in! The station's self-destruct sequence has been triggered-you have 90 minutes before total detonation. Get to the escape pod bay immediately!  

Type Reply to reply.
Radio: yo u need to reply. Type reply to reply

* * *

>n
command deck
The Command Deck - I need a description.

You can see a key here.

Radio: yo u need to reply. Type reply to reply

>s
Engineering Bay
The engineering bay - I need a description.

You can see a Repair Manual here.

Radio: yo u need to reply. Type reply to reply

* * *

>take radio
Radio: Engineer, come in! The station's self-destruct sequence has been triggered-you have 90 minutes before total detonation. Get to the escape pod bay immediately!  

Type Reply to reply.
Radio: yo u need to reply. Type reply to reply

>reply
You respond to the radio. Acknowledged. Heading to the escape pod now.

>reply
You respond to the radio. Acknowledged. Heading to the escape pod now.

>s
Escape Pod Bay
You can see a Battery Panel (closed) and a Control station (empty) here.

>s
You can't go that way.

* * *

>s
You might want to take the radio before going anywhere.

>push battery panel
Nothing obvious happens.

>push battery panel n
The Battery Panel cannot be pushed from place to place.

>open battery panek
I only understood you as far as wanting to open the Battery Panel.

>open battery panel
You open the Battery Panel.

>s
You can't go that way.

>n
Engineering Bay
You can see a radio here.

>n
command deck

>e
storage room
You can see a table (on which is a powerdrill) here.

>w
command deck

>s
Engineering Bay
You can see a radio here.

>n
command deck

* * *

>e
storage room
You can see a table (on which is a powerdrill) here.

>look
storage room
You can see a table (on which is a powerdrill) here.

>e
You can't go that way.

>s
You can't go that way.

>n
You can't go that way.

>w
command deck

>e
storage room
You can see a table (on which is a powerdrill) here.

>e
You can't go that way.

>e
You can't go that way.

>w
command deck

>w
Battery Room
You can see a Power Switch and a Main Battery Panel (closed) here.

>take power switch
That's fixed in place.

>turn powerswitch on
You can't see any such thing.

>turn power switch on
That's already on.

>switch power off
You switch the Power Switch off.

>switch power on
You switch the Power Switch on.

>open main battery panel
You open the Main Battery Panel, revealing an Ion Battery.

>take ion battery
You just got shocked!! Maybe we should try to turn the power off.

>turn off power
You switch the Power Switch off.

>take battery
(the Main Battery Panel)
Taken.

* * *

>s
You might want to take the radio before going anywhere.

>s
You can't go that way.

* * *

>n
You can't go that way.

>e
You can't go that way.

>w
You can't go that way.

>s
You can't go that way.

* * *

>s
You might want to take the radio before going anywhere.

>take radio
Radio: Engineer, come in! The station's self-destruct sequence has been triggered-you have 90 minutes before total detonation. Get to the escape pod bay immediately!  

Type Reply to reply.

>s
Escape Pod Bay
The Escape pod bay - 
There is one doorway: NORTH Engineering Bay

You can see a Battery Panel (closed), a Control station (empty) and a Takeoff Starter here.

Radio: Engineer, come in! Why haven't you taken off in the escape pod yet?

>n
Engineering Bay
The engineering bay - I need a description.

You can see a Repair Manual here.

>n
command deck
The Command Deck - I need a description.

You can see a key here.

>s
Engineering Bay
The engineering bay - I need a description.

You can see a Repair Manual here.

Radio: Engineer, come in! Is everything okay over there?

 Type reply to reply.

>reply
You respond to the radio: The pod is broken! I will have to do some repairs first.

Radio: Engineer, The station's going to blow soon - you need to get that thing fixed or you are toast!

>s
Escape Pod Bay
The Escape pod bay - I need a description.

You can see a Battery Panel (closed), a Control station (empty) and a Takeoff Starter here.

>s
You can't go that way.

>e
You can't go that way.

>n
Engineering Bay
The engineering bay - I need a description.

You can see a Repair Manual here.

>north
command deck
The Command Deck - I need a description.

You can see a key here.

I beg your pardon?

* * *

>n
Engineering Bay
The engineering bay - I need a description.

You can see a Repair Manual here.

>s
Escape Pod Bay
The Escape pod bay - I need a description.

You can see a Battery Panel (closed) and a Control station (empty) here.

>n
Engineering Bay
The engineering bay - I need a description.

>s
Escape Pod Bay
The Escape pod bay - I need a description.

You can see a Battery Panel (closed) and a Control station (empty) here.

* * *

>s
Escape Pod Bay
The Escape pod bay - 
There is one doorway: NORTH Engineering Bay

You can see a Battery Panel (closed), a Control station (empty) and a Takeoff Starter here.

Radio: Engineer, come in! Why haven't you taken off in the escape pod yet?

>reply
You respond to the radio: The pod is broken! I will have to do some repairs first.

Radio: Engineer, The station's going to blow soon - you need to get that thing fixed or you are toast!

>n
Engineering Bay
You step into the bay, the room is filled with work benches and repair various repair manuals.
There are two doorways: NORTH Command Deck SOUTH Escape Pod Bay 

You can see a Repair Manual and an Escape Pod Control Manual here.

>n
Command Deck
The Commanders Deck, much command 
There are three doorways: EAST Storage Room SOUTH Engineering Bay WEST Battery Room

You can see a key here.

* * *

>reply
You respond to the radio: The pod is broken! I will have to do some repairs first.

Radio: Engineer, The station's going to blow soon - you need to get that thing fixed or you are toast!

>reply
You respond to the radio: How much time do I have??

Radio: You've got 119 minutes until the station self destructs!

>reply
You respond to the radio: How much time do I have??

Radio: You've got 119 minutes until the station self destructs!

>s
You can't go that way.

>reply
You respond to the radio: How much time do I have??

Radio: You've got 119 minutes until the station self destructs!

* * *

>look
Engineering Bay
The engineering bay - I need a description.

* * *

>s
Escape Pod Bay
The Escape pod bay - 
There is one doorway: NORTH Engineering Bay

You can see a Battery Panel (closed), a Control station (empty) and a Takeoff Starter here.

Radio: Engineer, come in! Why haven't you taken off in the escape pod yet?

>take all
There are none at all available!

>s
You can't go that way.

>n
Engineering Bay
The engineering bay - I need a description.

You can see a Repair Manual here.

>take repair manual
Taken.

Radio: Engineer, come in! Is everything okay over there?

 Type reply to reply.

>s
Escape Pod Bay
The Escape pod bay - I need a description.

You can see a Battery Panel (closed), a Control station (empty) and a Takeoff Starter here.

Radio: Engineer, come in! Is everything okay over there?

 Type reply to reply.

>reply
You respond to the radio: The pod is broken! I will have to do some repairs first.

Radio: Engineer, The station's going to blow soon - you need to get that thing fixed or you are toast!

>e
You can't go that way.

* * *

>s
You can't go that way.

>w
You can't go that way.

>e
You can't go that way.

>n
Engineering Bay
The engineering bay - I need a description.

>n
command deck
The Command Deck - I need a description.

You can see a key here.

>e
storage room
The Storage Room - I need a description.

You can see a table (on which is a power drill), a container 379c (closed), a container 247e (closed), a container 276d (closed), a container 321b (closed), a container 277d (closed), a container 283c (closed) and a container 347b (closed) here.

>open all
You can't use multiple objects with that verb.

>take all
container 379c: Taken.
container 247e: Taken.
container 276d: Taken.
container 321b: Taken.
container 277d: Taken.
container 283c: Taken.
container 347b: Taken.
power drill: Taken.

* * *

Space-Station-Escape
An Interactive Fiction by Ashton Smith
Release 1 / Serial number 250528 / Inform 7 build 6M62 (I6/v6.34 lib 6/12N) SD

Engineering Bay
You step into the bay. The room is cluttered with workbenches, oscilloscopes, and spacecraft schematics, all showing signs of frantic last-minute repairs.
There are two doorways: NORTH Command Deck SOUTH Escape Pod Bay 

You can see a radio, a MSDS Cabinet (closed) and a Tool Cabinet (closed) here.

>south
You might want to take the radio before going anywhere.

>take radio
Radio: Engineer, come in! The station's self-destruct sequence has been triggered-you have 90 minutes before total detonation. Get to the escape pod bay immediately!  Type Reply to reply.

>south
Escape Pod Bay
The Escape pod bay - I need a description.

You can see a Battery Panel (closed) and a Control station (empty) here.

* * *

Space-Station-Escape
An Interactive Fiction by Ashton Smith
Release 1 / Serial number 250528 / Inform 7 build 6M62 (I6/v6.34 lib 6/12N) SD

Engineering Bay
You step into the bay. The room is cluttered with workbenches, oscilloscopes, and spacecraft schematics, all showing signs of frantic last-minute repairs.
There are two doorways: NORTH Command Deck SOUTH Escape Pod Bay 

You can see a radio, a MSDS Cabinet (closed) and a Tool Cabinet (closed) here.

>take radio
Radio: Engineer, come in! The station's self-destruct sequence has been triggered-you have 90 minutes before total detonation. Get to the escape pod bay immediately!  

Type Reply to reply.

>n
command deck
The Command Deck - I need a description.

You can see a key here.

>e
storage room
The Storage Room - I need a description.

You can see a table (on which are a power drill and a steering wheel) here.

>take power drill
Taken.

>w
command deck
The Command Deck - I need a description.

You can see a key here.

>w
Battery Room
The Battery Room - I need a description.

You can see a Power Switch and a Main Battery Panel (closed) here.

>open main battery panel
It seems to be locked.

>open main battery panel
It seems to be locked.

>open main battery panel wiht power drill
I only understood you as far as wanting to open the Main Battery Panel.

>open main battery panel with power drill
You unlock the Main Battery Panel.

>open main battery panel
You open the Main Battery Panel, revealing an Ion Battery.

* * *

>take ion battery
You just got shocked!! Maybe we should try to turn the power off.

>turn off power
(the power drill)
It isn't something you can switch.

* * *

>turn off power switch
You switch the Power Switch off.

>take battery
(the Main Battery Panel)
That's fixed in place.

* * *

>w
The doors are inoperable while the power is off.

>turn power switch on
You switch the Power Switch on.

>w
You can't go that way.

>e
command deck
The Command Deck - I need a description.

You can see a key here.

>take key chain
I only understood you as far as wanting to take the key.

>install steering wheel
You can't see any such thing.

>install steering wheel in the control station
You can't see any such thing.

>e
storage room
The Storage Room - I need a description.

You can see a table (on which is a steering wheel) here.

>take steering wheel
Taken.

>e
You can't go that way.

>w
command deck
The Command Deck - I need a description.

You can see a key here.

>n
You can't go that way.

>s
Engineering Bay
The engineering bay - I need a description.

You can see a Repair Manual here.

>s
Escape Pod Bay
The Escape pod bay - I need a description.

You can see a Battery Panel (closed), a Control station (empty) and a Takeoff Starter here.

Radio: Engineer, come in! Why haven't you taken off in the escape pod yet?

>install steering wheel on control station
I didn't understand that sentence.

>install
What do you want to install?

>install the steering wheel on the control station
I didn't understand that sentence.

>install steering wheel in control station
You snap the steering wheel into place. The control panel lights up with a hum.

>n
Engineering Bay
The engineering bay - I need a description.

You can see a Repair Manual here.

>take repair manual
Taken.

* * *

>x repair manual
The repair manual is an old book on space station repair, you quickly flip through it and take note of some key details:

- To install components like a steering wheel, try typing install steering wheel in control station.

- To open sealed panels, you may need a tool. Try typing open panel with power drill.

- To install batteries: Try typing put the ion battery in the battery panel.

It also mentions something about ensuring power is turned off before handling high-voltage components.

>install
What do you want to install?

>look
Engineering Bay
The engineering bay - I need a description.

>s
Escape Pod Bay
The Escape pod bay - I need a description.

You can see a Battery Panel (closed), a Control station (in which is a steering wheel) and a Takeoff Starter here.

>open battery panel
You open the Battery Panel.

>install iorn battery
You can't see any such thing.

>switch on takeoff starter
You need a key to start the pod.

>install ion battery
What do you want to install the Ion Battery in?

>install ion battery in the battery panel
That doesn't look like it belongs in the control station.

>look
Escape Pod Bay
The Escape pod bay - I need a description.

You can see a Battery Panel (empty), a Control station (in which is a steering wheel) and a Takeoff Starter here.

>install ion battery in battery panel
That doesn't look like it belongs in the control station.

>put the ion battery in the battery panel
You put the Ion Battery into the Battery Panel.

>turn on takeoff starter
You need a key to start the pod.

>i
You are carrying:
  a Repair Manual
  a power drill
  a radio

>n
Engineering Bay
The engineering bay - I need a description.

* * *

>s
Engineering Bay
The engineering bay - I need a description.

>s
Escape Pod Bay
The Escape pod bay - I need a description.

You can see a Battery Panel (in which is an Ion Battery), a Control station (in which is a steering wheel) and a Takeoff Starter here.

>turn on takeoff starter
You insert the keys and twist. The pod vibrates as it starts, systems come online, and you're launched into space. You made it!
You try to start the pod, but the system errors out. Maybe something important is missing.

    *** You escaped just in time! ***

Would you like to RESTART, RESTORE a saved game, QUIT or UNDO the last command?

>i
Please give one of the answers above.

Would you like to RESTART, RESTORE a saved game, QUIT or UNDO the last command?

* * *

>n
command deck
The Command Deck - I need a description.

You can see a key here.

>s
Engineering Bay

>e
You can't go that way.

* * *

>w
You can't go that way.

>n
command deck

* * *

>s
Engineering Bay

>s
Radio: Engineer, come in! Why haven't you taken off in the escape pod yet?

>n
Engineering Bay

>s
Escape Pod Bay
You can see a Battery Panel (closed) and a Control station (empty) here.

>reply to radio
You respond to the radio. Acknowledged. Heading to the escape pod now.

* * *

>reply
You respond to the radio: Acknowledged. Heading to the escape pod now.

>n
There is no reason to go this way! Lets get to the escape pod immediatley!

command deck
The Command Deck - I need a description.

You can see a key here.

>s
Engineering Bay
The engineering bay - I need a description.

You can see a Repair Manual here.

* * *

>reply
You respond to the radio: Acknowledged. Heading to the escape pod now.

>reply
BOOP

>reply
BOOP

>s
Escape Pod Bay
The Escape pod bay - I need a description.

You can see a Battery Panel (closed) and a Control station (empty) here.

Radio: Engineer, come in! Why haven't you taken off in the escape pod yet?

>reply
You respond to the radio: The pod is broken! I will have to do some repairs first.

Radio: Engineer, The station's going to blow soon - you need to get that thing fixed or you are toast!

>reply
You respond to the radio: How much time do I have??

Radio: You've got 120 minutes until the station self destructs!

>reply
You respond to the radio: How much time do I have??

Radio: You've got 120 minutes until the station self destructs!

* * *

>reply
BOOP

>s
Escape Pod Bay
You can see a Battery Panel (closed) and a Control station (empty) here.

* * *

>s
You can't go that way.

>look
Escape Pod Bay
You can see a Battery Panel (closed) and a Control station (empty) here.

* * *

>reply
You respond to the radio: Acknowledged. Heading to the escape pod now.

>s
Radio: Engineer, come in! Why haven't you taken off in the escape pod yet?
Escape Pod Bay
You can see a Battery Panel (closed) and a Control station (empty) here.

>reply
You respond to the radio: The pod is broken! I will have to do some repairs first.

>n
Engineering Bay

* * *

>take radio
Radio: Engineer, come in! The station's self-destruct sequence has been triggered-you have 90 minutes before total detonation. Get to the escape pod bay immediately!  

Type Reply to reply.

>s
Escape Pod Bay
A cramped escape pod awaits - a last resort for emergencies. Panoramic windows reveal the cold expanse of space and a faint glimmer of the approaching rescue ship.
There is one doorway: NORTH Engineering Bay

You can see a Battery Panel (closed), a Control station (empty), a Takeoff Starter and a Cabin Storage (closed) here.

Radio: Engineer, come in! Why haven't you taken off in the escape pod yet?

>n
Engineering Bay
The engineering bay - I need a description.

You can see a Repair Manual here.

>e
You can't go that way.

* * *

>w
You can't go that way.

>n
command deck
The Command Deck - I need a description.

You can see a key here.

Radio: Engineer, come in! Is everything okay over there?

 Type reply to reply.

>reply
You respond to the radio: The pod is broken! I will have to do some repairs first.

Radio: Engineer, The station's going to blow soon - you need to get that thing fixed or you are toast!

>e
storage room
The Storage Room - I need a description.

You can see a table (on which is a power drill), a container 411a (closed), a container 441d (closed), a container 137a (closed), a container 314a (closed), a container 283b (closed), a container 425d (closed) and a container 225c (closed) here.

>open all
You can't use multiple objects with that verb.

>take all
power drill: Taken.

>open container 453c
Which do you mean, the container 411a, the container 441d, the container 137a, the container 314a, the container 283b, the container 425d or the container 225c?

>open container
Which do you mean, the container 411a, the container 441d, the container 137a, the container 314a, the container 283b, the container 425d or the container 225c?

>open container 453c
Which do you mean, the container 411a, the container 441d, the container 137a, the container 314a, the container 283b, the container 425d or the container 225c?

>open
What do you want to open?

>open container 411a
You open the container 411a, revealing a welding goggles, a power cell and a first aid kit.

>open 441d
You open the container 441d, revealing a toolkit, a magnetic boots and a plasma torch.

>open 137a
You open the container 137a, revealing a hull patch kit, a communication headset and a repair drone.

>open 314a
You open the container 314a, revealing a spare circuit board, a gravity stabilizer module and a navigation manual.

>open 283b
You open the container 283b, revealing a vacuum-sealed food pack, a steering wheel and an emergency oxygen tank.

>open 425b
You can't see any such thing.

>look
storage room
The Storage Room - I need a description.

You can see a table, a container 411a (in which are a welding goggles, a power cell and a first aid kit), a container 441d (in which are a toolkit, a magnetic boots and a plasma torch), a container 137a (in which are a hull patch kit, a communication headset and a repair drone), a container 314a (in which are a spare circuit board, a gravity stabilizer module and a navigation manual), a container 283b (in which are a vacuum-sealed food pack, a steering wheel and an emergency oxygen tank), a container 425d (closed) and a container 225c (closed) here.

>open all
You can't use multiple objects with that verb.

>open container 411a
That's already open.

>open container 283b
That's already open.

>open 314a
That's already open.

>x 314a
A small container with a few items inside.

In the container 314a are a spare circuit board, a gravity stabilizer module and a navigation manual.

* * *

>s
Escape Pod Bay
A cramped escape pod awaits - a last resort for emergencies. Panoramic windows reveal the cold expanse of space and a faint glimmer of the approaching rescue ship.
There is one doorway: NORTH Engineering Bay

You can see a Battery Panel (closed), a Control station (empty), a Takeoff Starter and a Cabin Storage (closed) here.

Radio: Engineer, come in! Why haven't you taken off in the escape pod yet?

>open all
You can't use multiple objects with that verb.

>open control station
It isn't something you can open.

>open battery panel
You open the Battery Panel.

>open cabin storage
You open the Cabin Storage, revealing an Escape Pod Control Manual.

>take escape pod control manual
Taken.

Radio: Engineer, come in! Is everything okay over there?

 Type reply to reply.

>reply
You respond to the radio: The pod is broken! I will have to do some repairs first.

Radio: Engineer, The station's going to blow soon - you need to get that thing fixed or you are toast!

>n
Engineering Bay
You step into the bay. The room is cluttered with workbenches, oscilloscopes, and spacecraft schematics, all showing signs of frantic last-minute repairs.
There are two doorways: NORTH Command Deck SOUTH Escape Pod Bay 

You can see a MSDS Cabinet (closed) and a Tool Cabinet (closed) here.

>open tool cabinet
You open the Tool Cabinet, revealing a hammer and a Repair Manual.

>open repair manual
It isn't something you can open.

>take repair manual
Taken.

>n
Command Deck
The nerve center of the station, once full of activity - now quiet, with blinking consoles and flickering readouts.
There are three doorways: EAST Storage Room SOUTH Engineering Bay WEST Battery Room

You can see a console and a chair (on which is a Captain's Glove) here.

>take captain's glove
Taken.

>x console
A central control console with various blinking lights. A drawer is built into the frame, but it appears to be locked by a biometric scanner.

Radio: 45 minutes remain! If you can't figure out how to fix something try checking a Repair Manual!

>use captain's glove on console
That doesn't seem to work.

>x console
A central control console with various blinking lights. A drawer is built into the frame, but it appears to be locked by a biometric scanner.

>user captain's glove on biometeric scanner
That's not a verb I recognise.

>look
Command Deck
The nerve center of the station, once full of activity - now quiet, with blinking consoles and flickering readouts.
There are three doorways: EAST Storage Room SOUTH Engineering Bay WEST Battery Room

You can see a console and a chair here.

>look console
A central control console with various blinking lights. A drawer is built into the frame, but it appears to be locked by a biometric scanner.

>use captain's glove on console
That doesn't seem to work.

>use captain's glove on console
That doesn't seem to work.

>i
You are carrying:
  a Captain's Glove
  a Repair Manual
  an Escape Pod Control Manual
  a radio

>use radio on console
That doesn't seem to work.

>use captain's glove on biometric scanner
You press the glove to the scanner. After a brief pause, the scanner beeps approvingly and the drawer pops open with a soft click.

>use captain's glove on scanner
You press the glove to the scanner. After a brief pause, the scanner beeps approvingly and the drawer pops open with a soft click.

>look
Command Deck
The nerve center of the station, once full of activity - now quiet, with blinking consoles and flickering readouts.
There are three doorways: EAST Storage Room SOUTH Engineering Bay WEST Battery Room

You can see a console and a chair here.

>open console
It isn't something you can open.

>open drawer
That's already open.

>look drawer
In the drawer is a key.

>take  key
Taken.

>take all
There are none at all available!

>i
You are carrying:
  a key
  a Captain's Glove
  a Repair Manual
  an Escape Pod Control Manual
  a radio

>e
Storage Room
Stacks of containers fill the room, dimly lit and heavy with the acrid smell of burnt rubber and scorched electronics. 
 There is one doorway: WEST Command Deck

You can see a table (on which is a power drill), a container 300b (closed), a container 184c (closed), a container 225d (closed), a container 178e (closed), a container 118e (closed), a container 434e (closed), a container 152a (closed), a container 217c (closed), a container 297b (closed), a container 115a (closed), a container 479a (closed), a container 257a (closed), a container 257c (closed), a container 240d (closed), a container 297a (closed), a container 433e (closed), a container 268e (closed), a container 379e (closed), a container 391b (closed) and a container 293c (closed) here.

>take power drill
Taken.

>i
You are carrying:
  a power drill
  a key
  a Captain's Glove
  a Repair Manual
  an Escape Pod Control Manual
  a radio

>x escape pod control manual
A worn manual detailing installation and use of the escape pod's steering system, filled with diagrams and engineering shorthand. Scribbled on the back is: container 297b.

* * *

>e
You can't go that way.

>w
Command Deck
The nerve center of the station, once full of activity - now quiet, with blinking consoles and flickering readouts.
There are three doorways: EAST Storage Room SOUTH Engineering Bay WEST Battery Room

You can see a console and a chair here.

>w
Battery Room
Dimly lit and filled with the hum of energy, the Battery Room houses the station's core power systems. Thick cables run along the walls, and a faint smell of ozone hangs in the air. 
There is one doorway: EAST Command Deck.

You can see a Power Switch and a Main Battery Panel (closed) here.

>open main battery panel
The battery panel is secured with screws. You will need to unscrew them to open it.

>unscrew main battery panel with power drill
You drive the power drill into the screws. One by one they come loose with a whine, and the panel is now unscrewed.

>unscrew main battery panel
You must supply a second noun.

>open main battery panel
You open the Main Battery Panel, revealing an Ion Battery.

Radio: You've got 20 minutes remaining until the station explodes! You need to get moving!

>take ion battery
You just got shocked!! Maybe you should try to turn off the power switch next time.

>turn off power switch
You switch the Power Switch off.

* * *

>i
You are carrying:
  an Ion Battery
  a steering wheel
  a power drill
  a key
  a Captain's Glove
  a Repair Manual
  an Escape Pod Control Manual
  a radio

>reply
You respond to the radio: How much time do I have??

Radio: You've got 16.0 minutes until the station self destructs!

>s
The doors are inoperable while the power is off. Turn On the power switch if you are done here!

>look
Battery Room
Dimly lit and filled with the hum of energy, the Battery Room houses the station's core power systems. Thick cables run along the walls, and a faint smell of ozone hangs in the air. 
There is one doorway: EAST Command Deck.

You can see a Power Switch and a Main Battery Panel (empty) here.

>e
The doors are inoperable while the power is off. Turn On the power switch if you are done here!

>turn on power stich
You can't see any such thing.

>turn power switch
You must supply a second noun.

>turn on power switch
You switch the Power Switch on.

* * *

>s
Escape Pod Bay
A cramped escape pod awaits - a last resort for emergencies. Panoramic windows reveal the cold expanse of space and a faint glimmer of the approaching rescue ship.
There is one doorway: NORTH Engineering Bay

You can see a Battery Panel (closed), a Control station (empty), a Takeoff Starter and a Cabin Storage (closed) here.

Radio: Engineer, come in! Why haven't you taken off in the escape pod yet?

>reply
You respond to the radio: The pod is broken! I will have to do some repairs first.

Radio: Engineer, The station's going to blow soon - you need to get that thing fixed or you are toast!

* * *

>reply
You respond to the radio: How much time do I have??

Radio: You've got 119 minutes until the station self destructs!

>reply
You respond to the radio. Acknowledged. Heading to the escape pod now.

* * *

>s
You can't go that way.

>n
Engineering Bay
The engineering bay - I need a description.

>e
You can't go that way.

>s
Escape Pod Bay
The Escape pod bay - I need a description.

You can see a Battery Panel (closed) and a Control station (empty) here.

* * *

>n
Engineering Bay
The engineering bay - I need a description.

>n
command deck
The Command Deck - I need a description.

You can see a key chain here.

>look
command deck
The Command Deck - I need a description.

You can see a key chain here.

>e
storage room
The Storage Room - I need a description.

You can see a table (on which is a power drill) here.

>w
command deck
The Command Deck - I need a description.

You can see a key chain here.

>w
Battery Room
The Battery Room - I need a description.

You can see a Power Switch and a Main Battery Panel (closed) here.

>open battery panel
You open the Main Battery Panel, revealing an Ion Battery.

>take battery
(the Main Battery Panel)
That's fixed in place.

>i
You are carrying:
  a radio

>take ion battery
You just got shocked!! Maybe we should try to turn the power off.

>take ion battery
You just got shocked!! Maybe we should try to turn the power off.

>turn off power switch
You switch the Power Switch off.

* * *

>s
The doors are inoperable while the power is off.

>turn on power
You switch the Power Switch on.

>s
You can't go that way.

* * *

>w
You can't go that way.

>e
command deck
The Command Deck - I need a description.

You can see a key chain here.

>reply
You respond to the radio: How much time do I have??

Radio: You've got 111 minutes until the station self destructs!

>w
Battery Room
The Battery Room - I need a description.

You can see a Power Switch and a Main Battery Panel (empty) here.

>close main battery panel
You close the Main Battery Panel.

>open main battery panel with power drill
I only understood you as far as wanting to open the Main Battery Panel with the Power Switch.

>open batter panel
You can't see any such thing.

>open battery panel
You open the Main Battery Panel.

>w
You can't go that way.

* * *

>s
You can't go that way.

>e
command deck
The Command Deck - I need a description.

You can see a key chain here.

>e
storage room
The Storage Room - I need a description.

You can see a table (on which is a power drill) here.

>take power drill
Taken.

I beg your pardon?

>w
command deck
The Command Deck - I need a description.

You can see a key chain here.

>w
Battery Room
The Battery Room - I need a description.

You can see a Power Switch and a Main Battery Panel (empty) here.

>open main battery panel with power drill
That's unlocked at the moment.

>open main battery panel with power drill
That's unlocked at the moment.

>i
You are carrying:
  a power drill
  an Ion Battery
  a radio

>open main battery panel with x
You can't see any such thing.

>open main battery panel
That's already open.

>open main battery panel with radio
That's unlocked at the moment.

>open main battery panel
That's already open.

>open main battery panel with power drill
That's unlocked at the moment.

>open main battery panel
That's already open.

>open main battery panel
That's already open.

* * *

>take radio
Radio: Engineer, come in! The station's self-destruct sequence has been triggered-you have 90 minutes before total detonation. Get to the escape pod bay immediately!  

Type Reply to reply.

>south
Escape Pod Bay
A cramped escape pod awaits - a last resort for emergencies. Panoramic windows reveal the cold expanse of space and a faint glimmer of the approaching rescue ship.
There is one doorway: NORTH Engineering Bay

You can see a Battery Panel (closed), a Control station (empty), a Takeoff Starter and a Cabin Storage (closed) here.

Radio: Engineer, come in! Why haven't you taken off in the escape pod yet?

>open cabin storage
You open the Cabin Storage, revealing an Escape Pod Control Manual.

* * *

>take escape pod control manual
Taken.

>smell
You smell nothing unexpected.

>break it
Violence isn't the answer to this one.

Radio: Engineer, come in! Is everything okay over there?

 Type reply to reply.

>listen
You hear nothing unexpected.

Radio: Engineer, come in! Is everything okay over there?

 Type reply to reply.

>sleep
You aren't feeling especially drowsy.

Radio: Engineer, come in! Is everything okay over there?

 Type reply to reply.

>wake up
The dreadful truth is, this is not a dream.

Radio: Engineer, come in! Is everything okay over there?

 Type reply to reply.

>jump
You jump on the spot.

Radio: Engineer, come in! Is everything okay over there?

 Type reply to reply.

>curse
That's not a verb I recognise.

>undo
Escape Pod Bay
[Previous turn undone.]

>undo
Escape Pod Bay
[Previous turn undone.]

>sing
That's not a verb I recognise.

>search
What do you want to search?

>search everything
You can't use multiple objects with that verb.

>look
Escape Pod Bay
A cramped escape pod awaits - a last resort for emergencies. Panoramic windows reveal the cold expanse of space and a faint glimmer of the approaching rescue ship.
There is one doorway: NORTH Engineering Bay

You can see a Battery Panel (closed), a Control station (empty), a Takeoff Starter and a Cabin Storage (empty) here.

Radio: Engineer, come in! Is everything okay over there?

 Type reply to reply.

>search control station
The Control station is empty.

Radio: Engineer, come in! Is everything okay over there?

 Type reply to reply.

>drink
What do you want to drink?

>drink it
There's nothing suitable to drink here.

Radio: Engineer, come in! Is everything okay over there?

 Type reply to reply.

Radio: 45 minutes remain! If you can't figure out how to fix something try checking a Repair Manual!

>reply
You respond to the radio: The pod is broken! I will have to do some repairs first.

Radio: Engineer, The station's going to blow soon - you need to get that thing fixed or you are toast!

>s
You can't go that way.

>help
That's not a verb I recognise.

>about
That's not a verb I recognise.

>info
That's not a verb I recognise.

>ne
You can't go that way.

>wait
Time passes.

>wait
Time passes.

>wait 100
I only understood you as far as wanting to wait.

>wait
Time passes.

* * *

>south
Escape Pod Bay
A cramped escape pod awaits - a last resort for emergencies. Panoramic windows reveal the cold expanse of space and a faint glimmer of the approaching rescue ship.
There is one doorway: NORTH Engineering Bay

You can see a Battery Panel (closed), a Control station (empty), a Takeoff Starter and a Cabin Storage (closed) here.

Radio: Engineer, come in! Why haven't you taken off in the escape pod yet?

>s
You can't go that way.

* * *

>n
Engineering Bay
The engineering bay - I need a description.

>n
command deck
The Command Deck - I need a description.

>s
Engineering Bay
The engineering bay - I need a description.

>n
command deck
The Command Deck - I need a description.

>e
storage room
The Storage Room - I need a description.

You can see a table (on which is a powerdrill) here.

>w
command deck
The Command Deck - I need a description.

* * *

>w
Battery Room
The Battery Room - I need a description.

You can see a Power Switch and a Main Battery Panel (closed) here.

>w
You can't go that way.

>look
Battery Room
The Battery Room - I need a description.

You can see a Power Switch and a Main Battery Panel (closed) here.

* * *

Space-Station-Escape
An Interactive Fiction by Ashton Smith
Release 1 / Serial number 250528 / Inform 7 build 6M62 (I6/v6.34 lib 6/12N) SD

Engineering Bay
You step into the bay. The room is cluttered with workbenches, oscilloscopes, and spacecraft schematics, all showing signs of frantic last-minute repairs.
There are two doorways: NORTH Command Deck SOUTH Escape Pod Bay 

You can see a radio, a MSDS Cabinet (closed) and a Tool Cabinet (closed) here.

>test
>--> The following tests are available:
'test storage_generation'

>test storage_generation
(Testing.)

>[1] take radio
Radio: Engineer, come in! The station's self-destruct sequence has been triggered-you have 90 minutes before total detonation. Get to the escape pod bay immediately!  

Type Reply to reply.
>[2] s

Escape Pod Bay
A cramped escape pod awaits - a last resort for emergencies. Panoramic windows reveal the cold expanse of space and a faint glimmer of the approaching rescue ship.
There is one doorway: NORTH Engineering Bay

You can see a Battery Panel (closed), a Control station (empty), a Takeoff Starter and a Cabin Storage (closed) here.

Radio: Engineer, come in! Why haven't you taken off in the escape pod yet?
>[3] reply
You respond to the radio: The pod is broken! I will have to do some repairs first.

Radio: Engineer, The station's going to blow soon - you need to get that thing fixed or you are toast! 
>[4] n

Engineering Bay
You step into the bay. The room is cluttered with workbenches, oscilloscopes, and spacecraft schematics, all showing signs of frantic last-minute repairs.
There are two doorways: NORTH Command Deck SOUTH Escape Pod Bay 

You can see a MSDS Cabinet (closed) and a Tool Cabinet (closed) here.

>[5] take steering wheel manual
You can't see any such thing.

>[6] n

Command Deck
The nerve center of the station, once full of activity - now quiet, with blinking consoles and flickering readouts.
There are three doorways: EAST Storage Room SOUTH Engineering Bay WEST Battery Room

You can see a console and a chair (on which is a Captain's Glove) here.

>[7] x steering wheel manual
You can't see any such thing.

>[8] e

Storage Room
Stacks of containers fill the room, dimly lit and heavy with the acrid smell of burnt rubber and scorched electronics. 
 There is one doorway: WEST Command Deck

You can see a table (on which is a power drill), a container 300b (closed), a container 184c (closed), a container 225d (closed), a container 178e (closed), a container 118e (closed), a container 434e (closed), a container 152a (closed), a container 217c (closed), a container 297b (closed), a container 115a (closed), a container 479a (closed), a container 257a (closed), a container 257c (closed), a container 240d (closed), a container 297a (closed), a container 433e (closed), a container 268e (closed), a container 379e (closed), a container 391b (closed) and a container 293c (closed) here.

>[9] open container 297b
You open the container 297b, revealing a steering wheel, a spare landing gear spring and a plasma torch.

>[10] take steering wheel
Taken.

* * *

Space-Station-Escape
An Interactive Fiction by Ashton Smith
Release 1 / Serial number 250528 / Inform 7 build 6M62 (I6/v6.34 lib 6/12N) SD

Engineering Bay
You step into the bay. The room is cluttered with workbenches, oscilloscopes, and spacecraft schematics, all showing signs of frantic last-minute repairs.
There are two doorways: NORTH Command Deck SOUTH Escape Pod Bay 

You can see a radio, a MSDS Cabinet (closed) and a Tool Cabinet (closed) here.

>test storage_generation
(Testing.)

>[1] take radio
Radio: Engineer, come in! The station's self-destruct sequence has been triggered-you have 90 minutes before total detonation. Get to the escape pod bay immediately!  

Type Reply to reply.
>[2] s

Escape Pod Bay
The Escape pod bay - I need a description.

You can see a Battery Panel (closed), a Control station (empty) and a Takeoff Starter here.

Radio: Engineer, come in! Why haven't you taken off in the escape pod yet?
>[3] reply
You respond to the radio: The pod is broken! I will have to do some repairs first.

Radio: Engineer, The station's going to blow soon - you need to get that thing fixed or you are toast! 
>[4] n

Engineering Bay
The engineering bay - I need a description.

You can see a Repair Manual and a steering wheel manual here.

>[5] take steering wheel manual
Taken.

>[6] n

command deck
The Command Deck - I need a description.

You can see a key here.

>[7] x steering wheel manual
A manual for the steering wheel, with some diagrams and instructions. Scribbled on the back is stored in: container 297b

>[8] e

storage room
The Storage Room - I need a description.

You can see a table (on which is a power drill), a container 300b (closed), a container 184c (closed), a container 225d (closed), a container 178e (closed), a container 118e (closed), a container 434e (closed), a container 152a (closed), a container 217c (closed), a container 297b (closed), a container 115a (closed), a container 479a (closed), a container 257a (closed), a container 257c (closed), a container 240d (closed), a container 297a (closed), a container 433e (closed), a container 268e (closed), a container 379e (closed), a container 391b (closed) and a container 293c (closed) here.

>[9] open container 297b
You open the container 297b, revealing a steering wheel, a spare landing gear spring and a plasma torch.

>[10] take steering wheel
(the steering wheel)
Taken.

>take all
power drill: Taken.
spare landing gear spring: Taken.
plasma torch: Taken.

>x spare landing gear spring
is coiled tightly

>x plasma torch
is glowing faintly

>open 379
You can't see any such thing.

>open 379e
You open the container 379e, revealing a spare circuit board, a damaged helmet and a navigation module.

* * *

>test storage_generation
(Testing.)

>[1] n
There is no reason to go this way! Lets get to the escape pod immediatley!

>e
You might want to take the radio before going anywhere.

>s
You might want to take the radio before going anywhere.

* * *

>take radio
Radio: Engineer, come in! The station's self-destruct sequence has been triggered-you have 90 minutes before total detonation. Get to the escape pod bay immediately!  

Type Reply to reply.

>s
Escape Pod Bay
The Escape pod bay - I need a description.

You can see a Battery Panel (closed), a Control station (empty) and a Takeoff Starter here.

Radio: Engineer, come in! Is everything okay over there?

 Type reply to reply.

Radio: Engineer, come in! Why haven't you taken off in the escape pod yet?

>reply
You respond to the radio: The pod is broken! I will have to do some repairs first.

Radio: Engineer, The station's going to blow soon - you need to get that thing fixed or you are toast!

* * *

>n
command deck
The Command Deck - I need a description.

You can see a key here.

>e
storage room
The Storage Room - I need a description.

You can see a table (on which is a power drill), a container 300b (closed), a container 184c (closed), a container 225d (closed), a container 178e (closed), a container 118e (closed), a container 434e (closed), a container 152a (closed), a container 217c (closed), a container 297b (closed), a container 115a (closed), a container 479a (closed), a container 257a (closed), a container 257c (closed), a container 240d (closed), a container 297a (closed), a container 433e (closed), a container 268e (closed), a container 379e (closed), a container 391b (closed) and a container 293c (closed) here.

>s
You can't go that way.

>w
command deck
The Command Deck - I need a description.

You can see a key here.

>s
Engineering Bay
The engineering bay - I need a description.

You can see a Repair Manual and a steering wheel manual here.

>take steering wheel manual
Taken.

>x steering wheel manual
A manual for the steering wheel, with some diagrams and instructions. Scribbled on the back is stored in: container 297b

>e
You can't go that way.

* * *

>w
You can't go that way.

>n
command deck
The Command Deck - I need a description.

You can see a key here.